#############
#           #
#           #
#   w    r  #
#           #
#           #
#           #
#           #
#   C    i  #
#           #
#           #
#           #
#############
